####################
#H................L#
#..................#
#....G........G....#
#..................#
#......#....S......#
#..................#
#..W............W..#
#..................#
#......S....#......#
#..................#
#....G........G....#
#..................#
#P........B........#
####################
