####################
#P.................#
#.....G............#
#.....###..........#
#.........W........#
#.........S........#
#..............E...#
#..............E...#
#.........B........#
####################
