####################
#P.................#
#.....G............#
#.....###..........#
#.........W........#
#.........S........#
#..............H...#
#..............L...#
#.........B........#
####################
