####################
#H....G....S....L..#
#.####..###..####..#
#......W.....G.....#
#.##.#####.#####...#
#....G......W......#
#.######..######...#
#........S.........#
#..####.....####...#
#..W.....G.....W...#
#..####..###..####.#
#......S.....G.....#
#.####......####...#
#P........B........#
####################
